+----------+
|#       # |
|##   ## #=|
|T#      #=|
|E##     #=|
|S       #=|
|T V     #=|
|##O##  ##=|
|#  ##   #=|
|#  ##   ==|
|##OOOO####|
+----------+
::size:12:12
::spawn:2:1
::msg3x1y:hello world_____________________________
::
