+-----------+
|=   >      |
|=####      |
|=         =|
|          =|
|          =|
|###  #####=|
|     O <  =|
|     O <  =|
|     #####=|
|       >  =|
|       >  =|
+-----------+
::size:13:13
::spawn:1:11
::
